#######
#@  # #
#   $ #
#   $ #
# ..  #
#  *  #
#######