#######
#@  # #
#   $ #
#   $ #
# ..  #
#  *  #
#######

                "              XXXXXXXX",
                "              X  ....X",
                "   XXXXXXXXXXXX  ....X",
                "   X    X  * *   ....X",
                "   X ***X*  * X  ....X",
                "   X  *     * X  ....X",
                "   X ** X* * *XXXXXXXX",
                "XXXX  * X     X       ",
                "X   X XXXXXXXXX       ",
                "X    *  XX            ",
                "X **X** @X            ",
                "X   X   XX            ",
                "XXXXXXXXX             "